1111111111
1P000001E1
1110111011
1C000000C1
1011111101
1C000000C1
1111111111
